map
################
#        OO    #
#              #
#              #
#       $$     #
#              #
#              #
# @            #
################
end